border_size=1
usage=map

Gg          , Gg          , Gg          , Gg          , Gg          , Gg          , Gg          , Gg          , Gg          , Gg          , Gg          , Gg          , Gg          , Gg          , Gg          , Gg          , Gg          , Gg          , Gg          , Gg          , Gg          , Gg          , Gg          , Gg          , Gg          , Gg          , Gg          , Gg          , Gg          , Gg          
Wo          , Wo          , Wo          , Wo          , Wo          , Wo          , Wo          , Wo          , Wo          , Gg          , Gg          , Gg          , Gg          , Gg          , Gg          , Wo          , Wo          , Gg          , Wo          , Gg          , Wo          , Gg          , Wo          , Gg          , Wo          , Gg          , Wo          , Gg          , Wo          , Gg          
Wo          , Wo          , Wo          , Wo          , Wo          , Wo          , Wo          , Wo          , Wo          , Wo          , Wo          , Wo          , Ww          , Gg          , Ww          , Wo          , Wo          , Wo          , Wo          , Wo          , Wo          , Wo          , Wo          , Wo          , Wo          , Wo          , Wo          , Wo          , Wo          , Wo          
Wo          , Wo          , Wo          , Wo          , Wo          , Wo          , Wo          , Wo          , Wo          , Wo          , Wo          , Wo          , Ww          , Ww          , Ww          , Ww          , Wo          , Wo          , Wo          , Wo          , Wo          , Wo          , Wo          , Wo          , Wo          , Wo          , Wo          , Wo          , Wo          , Wo          
Wo          , Wo          , Wo          , Wo          , Wo          , Wo          , Wo          , Wo          , Wo          , Wo          , Wo          , Wo          , Wo          , Ww          , Ww          , Ww          , Wo          , Wo          , Wo          , Wo          , Wo          , Wo          , Wo          , Wo          , Wo          , Wo          , Wo          , Wo          , Wo          , Wo          
Wo          , Wo          , Wo          , Wo          , Wo          , Wo          , Wo          , Wo          , Wo          , Wo          , Wo          , Wo          , Ww          , Ww          , Ww          , Wo          , Wo          , Wo          , Wo          , Wo          , Wo          , Wo          , Wo          , Wo          , Wo          , Wo          , Wo          , Wo          , Wo          , Wo          
Wo          , Wo          , Wo          , Wo          , Wo          , Wo          , Wo          , Wo          , Wo          , Wo          , Wo          , Wo          , Ww          , Ww          , Ww          , Wo          , Wo          , Wo          , Wo          , Wo          , Wo          , Wo          , Wo          , Wo          , Wo          , Wo          , Wo          , Wo          , Wo          , Wo          
Wo          , Wo          , Wo          , Wo          , Wo          , Wo          , Wo          , Wo          , Wo          , Wo          , Wo          , Wo          , Wo          , Ww          , Ww          , Ww          , Wo          , Wo          , Wo          , Wo          , Wo          , Wo          , Wo          , Wo          , Wo          , Wo          , Wo          , Wo          , Wo          , Wo          
Wo          , Wo          , Wo          , Wo          , Wo          , Wo          , Wo          , Wo          , Wo          , Wo          , Wo          , Wo          , Ww          , Ww          , Ww          , Ww          , Wo          , Wo          , Wo          , Wo          , Wo          , Wo          , Wo          , Wo          , Wo          , Wo          , Wo          , Wo          , Wo          , Wo          
Wo          , Wo          , Wo          , Wo          , Wo          , Wo          , Wo          , Wo          , Ww          , Wo          , Ww          , Wo          , Ww          , Ww          , Ww          , Wo          , Wo          , Wo          , Wo          , Wo          , Wo          , Wo          , Wo          , Wo          , Wo          , Wo          , Wo          , Wo          , Wo          , Wo          
Wo          , Wo          , Wo          , Wo          , Wo          , Wo          , Wo          , Ww          , Ww          , Ww          , Ww          , Ww          , Ww          , Ww          , Ww          , Wo          , Wo          , Wo          , Wo          , Wo          , Wo          , Wo          , Wo          , Wo          , Wo          , Wo          , Wo          , Wo          , Wo          , Wo          
Wo          , Wo          , Wo          , Wo          , Wo          , Wo          , Wo          , Ww          , Ww          , Ww          , Ww          , Ww          , Ww          , Ww          , Ww          , Ww          , Ww          , Ww          , Ww          , Ww          , Ww          , Wo          , Wo          , Wo          , Wo          , Wo          , Wo          , Wo          , Wo          , Wo          
Gs          , Wo          , Gs          , Wo          , Wo          , Wo          , Wo          , Wo          , Gs          , Ww          , Gs          , Ww          , Gs          , Ww          , Ww          , Ww          , Ww          , Ww          , Ww          , Ww          , Ww          , Wo          , Wo          , Wo          , Wo          , Wo          , Wo          , Wo          , Wo          , Wo          
Gg          , Gs          , Gg          , Gs          , Gg          , Gs          , Gs          , Gs          , Gs          , Gs          , Gs          , Gs          , Gs          , Ww          , Ww          , Ww          , Ww          , Ww          , Ww          , Ww          , Gg          , Wo          , Gs          , Wo          , Wo          , Wo          , Wo          , Wo          , Wo          , Wo          
Gs          , Gs^Fp       , Gs          , Gg          , Gg          , Gg          , Gg          , Gs          , Gs^Fp       , Gs          , Gs          , Gs          , Gs          , Gs          , Ch          , Rd          , Ggf         , Rd          , Gg          , Gg          , Ggf         , Gg          , Gs^Fds      , Gg          , Gg          , Gs          , Gs          , Gs          , Gs          , Gs          
Gs          , Gs          , Gg          , Gs          , Gg          , Gs          , Gg          , Gs^Fp       , Gs^Fp       , Gs^Fp       , Gg          , Gg          , Gg          , Ch          , Ch          , Rd          , Rd          , Rd          , Rd          , Gg          , Gs^Fds      , Gg          , Gg          , Gs          , Gs          , Gg          , Gs^Fds      , Gg          , Gs^Fds      , Gg          
Gs          , Gs          , Gs          , Gg          , Gs          , Gg          , Gs          , Gs^Fp       , Gs^Fp       , Gs^Fp       , Gg          , Gs          , Gs          , Kh          , Ch          , Rd          , Ggf         , Ggf         , Rd          , Gg          , Gg          , Gg          , Gs^Fds      , Gg          , Gs^Fp       , Gg          , Gg          , Gs          , Gs^Fds      , Gs          
Gg          , Gg^Vh       , Gg          , Gs          , Gg          , Gs^Vht      , Gg          , Gs          , Gs          , Gs          , Gs          , Gs          , Gs          , Ch          , Ch          , Rd          , Rd          , Rd          , Gs          , Ggf         , Ggf         , Gg          , Gs          , Gs          , Gg          , Gg          , Gs          , Gs          , Gs          , Gs          
Gg          , Gs          , Gs          , Gg          , Gs          , Gg          , Gg          , Gs          , Ch          , Gs          , Gg^Vh       , Gs          , Gs          , Gs          , Gs          , Gg          , Rd          , Gg          , Gs          , Gs          , Gs          , Gg          , Gs^Fds      , Gs^Fds      , Gs^Fds      , Gg          , Gg          , Gs          , Gs          , Gs          
Gg          , Gs          , Gs          , Gg^Wm       , Gs^Vht      , Gg^Vh       , Gs          , Gg          , Ch          , Gg^Vh       , Gg          , Gg^Vh       , Gg          , Gg          , Gs          , Rd          , Rd          , Gs          , Gs^Fds      , Gs          , Gs          , Gg          , Gs^Fds      , Gs^Fds      , Gs^Fds      , Gs^Fds      , Gg          , Gg          , Gs^Fds      , Gs          
Gs          , Gg          , Gg          , Gs          , Gg          , Gs          , Gs          , Ch          , Gs          , Gs          , Gg          , Gg          , Gs          , Gs          , Gs          , Rd          , Rd          , Gs          , Gs          , Gs          , Gg          , Gg          , Gg          , Gs^Fds      , Gs          , Gs^Fds      , Gs^Fds      , Gg          , Gg          , Gs          
Gs          , Gs          , Gs          , Gg          , Ch          , Gs          , Ch          , 2 Kh        , Ch          , Gg          , Gg          , Gg          , Gs          , Gg^Vh       , Gs          , Rd          , Rd          , Gs          , Gs          , Gs          , Gg          , Gg          , Gs^Fds      , Gs          , Gs          , Gs          , Gs          , Gg          , Gg          , Gs          
Gs          , Gs          , Gg^Vh       , Gg          , Gg          , Ch          , Gg          , Gg^Vh       , Ch          , Gg^Vh       , Gg          , Gg          , Gg          , Gg          , Gs          , Rd          , Rd          , Gs          , Gs          , Gg          , Gg          , Gg          , Gs          , Gs          , Gs          , Gs^Fds      , Gs          , Gg          , Gs^Fds      , Gg          
Gs          , Gs          , Gs          , Gs          , Gs          , Gg          , Gs          , Gg^Vh       , Gs          , Ch          , Gs          , Gg          , Gs          , Gs          , Gs          , 1 Rd        , Rd          , Gs          , Gs          , Gs^Fds      , Gs          , Gg          , Gg          , Gs          , Gg          , Gg          , Gs^Fds      , Gs^Fds      , Gs^Fds      , Gs          
Gs          , Gs          , Gs          , Gs          , Gs          , Gs          , Gs          , Gs          , Gs          , Gs          , Gs          , Gs          , Gs          , Gs          , Gs          , Rd          , Gs          , Gs          , Gs          , Gs          , Gs          , Gg          , Gs          , Gg          , Gg          , Gs^Fds      , Gs          , Gs          , Gs          , Gs          
