border_size=1
usage=map

Gg          , Rd          , Gg          , Gg          , Gg          , Gg          , Gg          , Gg          , Gg          , Gg          , Gg          , Gg          , Gg          , Gg          , Gg          , Gg          , Gg          , Gg          , Gg          , Gg          , Gg          , Gg          , Gg          , Gg          , Gg          , Gg          , Gg          , Gg          , Ww          , Ww          , Ww          , Ww          , Ww          , Ww          , Gg          , Gg          , Gg          , Gg          , Gg          , Gg          
Gg          , Rd          , Gg          , Gg          , Gg          , Gg          , Gg          , Gg          , Gg          , Gg          , Gg          , Gg          , Gg          , Gg          , Gg          , Gg          , Gg          , Gg          , Gg          , Gg          , Gg          , Gg          , Gg          , Gg          , Gg          , Gg^Vh       , Gg          , Ww          , Gg          , Ww          , Ww          , Ww          , Ww          , Ww          , Gg          , Gg          , Gg          , Gg          , Re^Gvs      , Re^Gvs      
Gs          , Rd          , Gg          , Gg          , Gg          , Gg          , Gg          , Gg          , Gg^Vh       , Gg          , Gg          , Gg          , Gg          , Gg          , Gg          , Gg          , Gg          , Gg          , Gg          , Gg          , Gg          , Gg          , Gg          , Gg          , Gg          , Gg          , Gg          , Gg          , Gg          , Gg          , Gg          , Ww          , Ww          , Ww          , Gg          , Gg^Wm       , Re^Gvs      , Re^Gvs      , Re^Gvs      , Re^Gvs      
Gs          , 2 Rd        , Rd          , Gg          , Gg          , Gg          , Gg          , Gg          , Gg          , Gg          , Gg          , Gg          , Gg          , Gg          , Gg          , Gg          , Gg          , Gg          , Gg          , Gg          , Gg          , Gg          , Gg          , Gg          , Gg          , Gg          , Gg          , Gg          , Gg          , Gg          , Gg          , Ww          , Ww          , Ww          , Gg          , Gg          , Gg          , Re^Gvs      , Re^Gvs      , Re^Gvs      
Gg          , Gg          , Rd          , Rd          , Rd          , Gs^Fp       , Gg          , Gg          , Gg          , Gg          , Gg          , Gg          , Gg          , Gg          , Gg          , Gg          , Gg          , Gs^Fms      , Gg          , Gg          , Gs^Fms      , Gs^Fp       , Gg          , Gg          , Gg          , Gg          , Rd          , Gg          , Rd          , Rd          , Rd          , Rd          , Ww^Bw/      , Wo^Bw/      , Ww          , Gg          , Gg          , Gg          , Gg          , Re^Gvs      
Gg          , Gg          , Gg          , Rd          , Gg          , Rd          , Rd          , Gg          , Gg          , Gg          , Gg          , Gg          , Gg          , Xos         , Xos         , Xos         , Xos         , Xos         , Gg          , Gg          , Rd          , Gg          , Rd          , Rd          , Rd          , Rd          , Gg          , Rd          , Gg          , Rd          , Gg          , Rd          , Ww          , Wo          , Wo          , Ww          , Gg          , Gg^Vh       , Gg          , Gg          
Gg          , Gg          , Gg          , Gg          , Gg          , Gs^Fp       , Gs^Fp       , Rd          , Rd          , Xos         , Xos         , Xos         , Xos         , Xos         , Xos         , Rr          , Rr          , Xos         , Xos         , Rr          , Rr          , Xos         , Xos         , Xos         , Xos         , Xos         , Gg          , Gg          , Gg          , Gg          , Gs^Fp       , Gg          , Gg          , Wo          , Wo          , Ww          , Gg          , Gg          , Gg          , Gg          
Gg          , Gg          , Gg          , Gg          , Gg          , Gg          , Gg          , Gg          , Xos         , Rr          , Rr          , Rr          , Rr          , Rr          , Xos         , Rr          , Rr          , Rr          , Rr          , Rr          , Xos         , Xos         , Rr          , Rr          , Rr          , Rr          , Xos         , Xos         , Gg          , Gg          , Gg          , Gg          , Gg          , Ww          , Wo          , Ww          , Ww          , Gg          , Gg          , Gg          
Gg          , Gg          , Gg          , Gg          , Gs^Fp       , Gg          , Gs^Fp       , Gg          , Xos         , Rr          , Rr          , Rr          , Rr          , Rr          , Xos         , Rr          , Rr          , Rr          , Rr          , Rr          , Rr          , Rr          , Rr          , Rr          , Rr          , Rr          , Rr          , Xos         , Gs          , Gg          , Gg          , Gg          , Ss^Vhs      , Ww          , Wo          , Ww          , Ww          , Gg          , Gg          , Gg          
Gg          , Gg          , Gg          , Gg          , Gg          , Gg          , Gg          , Gg          , Xos         , Rr          , Rr          , Rr          , Rr          , Rr          , Rr          , Rr          , Rr          , Cud         , Rr          , Rr          , Rr          , Rr          , Rr          , Xos         , Rr          , Rr          , Rr          , Xos         , Gs          , Gg          , Gg          , Gg          , Ss          , Ww          , Wo          , Ww          , Ww          , Gg          , Gg          , Gg          
Gg          , Gg          , Gg          , Gs^Fp       , Gg          , Gs^Fp       , Gs^Fp       , Gg          , Xos         , Rr          , Rr          , 1 Rr        , Rr          , Rr          , Xos         , Rr          , Rr          , Kud         , Rr          , Rr          , Rr          , Rr          , Rr          , Rr          , Rr          , Rr          , Rr          , Xos         , Gs          , Gg          , Gg          , Gg          , Wo          , Ww          , Wo          , Ww          , Ww          , Gg          , Gg          , Gg          
Gg          , Gg          , Gg          , Gg          , Gg          , Gs^Fp       , Gg          , Gg          , Xos         , Rr          , Rr          , Rr          , Rr          , Rr          , Xos         , Rr          , Rr          , Cud         , Rr          , Rr          , Rr          , Rr          , Rr          , Rr          , Rr          , Xos         , Xos         , Xos         , Gg          , Gg          , Gg          , Gg          , Wo          , Ss          , Wo          , Ww          , Gg          , Gg          , Gg          , Gg          
Gg          , Gg          , Gg          , Gg          , Gg          , Gg          , Gg          , Gg          , Xos         , Rr          , Rr          , Rr          , Rr          , Xos         , Xos         , Xos         , Xos         , Xos         , Xos         , Rr          , Xos         , Xos         , Xos         , Xos         , Xos         , Xos         , Rd          , Gg          , Rd          , Rd          , Rd          , Rd          , Rd          , Ww          , Wo          , Gg          , Gg          , Gg          , Gg          , Gg          
Gg          , Gg          , Gg          , Gg          , Gg          , Gs^Fp       , Gg          , Gg          , Xos         , Rr          , Rr          , Rr          , Xos         , Rr          , Xos         , Rr          , Rr          , Rr          , Rr          , Rr          , Rr          , Ur          , Ur^Ii       , Xos         , Gs          , Gs          , Gg          , Rd          , Gg          , Gg          , Gg          , Gg          , Gg          , Ww^Bw\      , Wo^Bw\      , Rd          , Gg          , Gg^Vh       , Gg          , Gg          
Gg          , Gg          , Gg          , Gg          , Gg          , Gg          , Gg          , Gg          , Xos         , Xos         , Xos         , Rr          , Rr          , Xos         , Rr          , Rr          , Rr          , Xos         , Rr          , Xos         , Xos         , Ur          , Ur          , Xos         , Gs          , Gs          , Gg          , Gg          , Gs^Fms      , Gg          , Gg^Vh       , Gg          , Gg          , Ww          , Wo          , Gg          , Gg          , Gg          , Gg          , Gg          
Gg          , Gg          , Gg          , Gg          , Gs^Fp       , Gs^Fp       , Gg          , Gg          , Xos         , Rr          , Rr          , Rr          , Rr          , Rr          , Rr          , Rr          , Rr          , Rr          , Rr          , Xos         , Ur          , Ur^Ii       , Ur          , Xos         , Gs          , Gg          , Gg          , Gg          , Gg          , Gg          , Gg          , Gg          , Gg          , Wo          , Wo          , Ww          , Gg          , Gg          , Gg          , Gg          
Gg          , Gg          , Gg          , Gs^Fp       , Gg          , Gg          , Gg          , Gg          , Xos         , Rr          , Rr          , Rr          , Rr          , Xos         , Rr          , Rr          , Rr          , Xos         , Rr          , Xos         , Ur          , Ur          , Ur          , Xos         , Gs^Fp       , Gg          , Gs^Fp       , Gg          , Gs^Fp       , Gg          , Gg          , Gg          , Gg^Vh       , Gg          , Wo^Bw/      , Gg          , Gg          , Gg^Vh       , Gg          , Gg          
Gg          , Gg          , Gg          , Gs^Fp       , Gg          , Gs^Fp       , Gg          , Rp          , Rr          , Xos         , Rr          , Rr          , Rr          , Rr          , Rr          , Rr          , Rr          , Rr          , Rr          , Xos         , Ur          , Ur^Ii       , Ur          , Xos         , Gg          , Gs^Fp       , Gg          , Gs^Fp       , Gs          , Gs          , Gg^Vh       , Gg          , Gg          , Gg          , Wo          , Ww          , Gg          , Gg          , Gg          , Gg          
Gg          , Gg          , Gg          , Gs^Fp       , Gg          , Rp          , Rp          , Gg          , Gg          , Xos         , Rr          , Rr          , Rr          , Rr          , Rr          , Rr          , Rr          , Rr          , Rr          , Xos         , Ur          , Ur          , Ur          , Xos         , Gs^Fp       , Gg          , Gs^Fp       , Gg          , Gg^Vh       , Gs          , Gs          , Gs          , Gg^Ve       , Gs          , Wo          , Ww          , Gg          , Gg^Vh       , Gg          , Gg          
Gg          , Gg          , Gg          , Gs^Fp       , Gg          , Rp          , Gg          , Gg          , Gg          , Xos         , Rr          , Rr          , Rr          , Rr          , Rr          , Rr          , Rr          , Rr          , Rr          , Xos         , Xos         , Xos         , Xos         , Xos         , Gg          , Gs^Fp       , Gg          , Gs^Fp       , Gg          , Gs          , Gs          , Gs          , Gg          , Gg          , Wo^Bw/      , Gg          , Gg          , Gg          , Gg          , Gg          
Gg          , Gg          , Gg          , Gg          , Rp          , Gg          , Rd          , Rp          , Rd          , Rd          , Xos         , Xos         , Xos         , Xos         , Xos         , Xos         , Xos         , Xos         , Xos         , Rr          , Rr          , Rr          , Rr          , Xos         , Gs^Fp       , Gg          , Gs^Fp       , Gg          , Gs^Fp       , Gg          , Gg^Vh       , Gg          , Gg          , Gg          , Wo          , Ww          , Gg          , Gg          , Gg          , Gg          
Gg          , Gg          , Gg          , Rp          , Rp          , Rp          , Gs^Fp       , Rp          , Gs^Fp       , Gg          , Xos         , Xos         , Ur          , Rr          , Ur          , Uu          , Uu          , Uu          , Uu          , Rr          , Xos         , Ur          , Ur          , Xos         , Gg          , Gs^Fp       , Gg          , Gs^Fp       , Gg          , Gs^Fp       , Gg          , Gg          , Gg          , Gg          , Wwf         , Ww          , Gg          , Gg          , Gg          , Gg          
Gg          , Gg          , Rp          , Rp          , Gg          , Gg          , Gg          , Gg          , Gg          , Gg          , Xos         , Rr          , Ur          , Ur          , Ur          , Uu          , Rr          , Rr          , Rr          , Rr          , Rr          , Rr          , Ur          , Xos         , Gg          , Gg          , Gg          , Gg          , Gg          , Gg          , Gg          , Gg          , Gg          , Gg          , Wwf         , Ww          , Gg          , Gg          , Gg          , Gg          
Rp          , Rp          , Gg          , Gg          , Gg          , Gg          , Gg          , Gg          , Gg          , Gg          , Xos         , Ur          , Ur          , Rr          , Ur          , Uu          , Rr          , Rr          , Rr          , Rr          , Rr          , Ur          , Ur          , Xos         , Gg          , Gg          , Gg          , Gg          , Gg          , Gg          , Gg          , Gg          , Gg          , Gg          , Ww          , Ww          , Wo          , Gg          , Gg          , Gg          
Rp          , Gg          , Gg          , Gg          , Gg          , Gg          , Gg          , Gg          , Gg          , Gg          , Gg          , Xos         , Ur          , Ur          , Ur          , Uu          , Rr          , Rr          , Ur          , Rr          , Rr          , Ur          , Ur          , Xos         , Gg          , Gg          , Gg          , Gg          , Gg          , Gg          , Gg          , Gg          , Gg          , Wo          , Wwf         , Ww          , Gg          , Gg          , Gg          , Gg          
Gg          , Gg          , Gg          , Gg          , Gg          , Gg          , Gg          , Gg          , Gg          , Gg          , Gg          , Xos         , Ur          , Ur          , Ur          , Ur          , Ur          , Ur          , Ur          , Ur          , Ur          , Ur          , Rr          , Xos         , Gg          , Gg          , Gg          , Gg          , Gg          , Gg          , Gg          , Gg          , Wo          , Wwf         , Wwf         , Ww          , Gg          , Gg          , Gg          , Gg          
Gg          , Gg          , Gg          , Gg          , Gg          , Gg          , Gg          , Gg          , Gg          , Gg          , Gg          , Xos         , Xos         , Xos         , Xos         , Xos         , Xos         , Xos         , Xos         , Xos         , Xos         , Xos         , Xos         , Xos         , Gg          , Gg          , Gg          , Gg          , Gg          , Gg          , Gg          , Gg          , Wwf         , Wwf         , Ww          , Ww          , Gg          , Gg          , Gg          , Gg          
