border_size=1
usage=map

Xos         , Xos         , Xos         , Xos         , Xos         , Xos         , Xos         , Xos         , Xos         , Xos         , Xos         , Xos         , Xos         , Xos         , Xos         , Xos         , Xos         , Xos         , Xos         , Xos         , Rr          , Xos         
Xos         , Xos         , Rr          , Rr          , Rr          , Rr          , Rr          , Rr          , Rr          , Rr          , Rr          , Rr          , Rr          , Rr          , Rr          , Rr          , Rr          , Rr          , Rr          , Rr          , Rr          , Rr          
Xos         , Rr          , Rr          , Xos         , Rr          , Rr          , Rr          , Xos         , Rr          , Rr          , Rr          , Rr          , 5 Rr        , Rr          , Rr          , Xos         , Rr          , Rr          , Rr          , Xos         , Rr          , Rr          
Xos         , Rr          , Rr          , Rr          , Rr          , Rr          , Rr          , Rr          , 2 Rr        , Rr          , Rr^Bw/      , Rr^Bw/      , Rr^Bw\      , 6 Rr        , 7 Rr        , Rr          , Rr          , Rr          , Rr          , Rr          , Rr          , Rr          
Rr          , Rr          , Rr          , Xos         , Rr          , Rr          , Rr          , Rr          , Rr^Bw/      , Rr^Bw/      , Rr          , Rr          , Rr          , Rr^Bw\      , Rr^Bw\      , Rr          , Rr          , Rr          , Rr          , Xos         , Rr          , Rr          
Rr          , 1 Rr        , Rr          , Rr          , Rr          , Rr          , Rr          , Rr          , Rr          , Rr          , Rr          , Rr          , Rr          , Rr          , Rr          , Rr          , Rr          , Rr          , Rr          , Rr          , Rr          , Rr          
Xos         , Rr          , Rr          , Xos         , Rr          , Rr          , Rr          , Xos         , Rr          , Rr          , Rr          , Rr          , Rr          , Rr          , Rr          , Xos         , Rr          , Rr          , Rr          , Xos         , Rr          , Rr          
Xos         , Rr          , Rr          , Rr          , Rr          , Rr          , Rr          , Rr          , Rr          , Rr          , Rr          , 9 Rr        , Rr          , Rr          , Rr          , Rr          , Rr          , Rr          , Rr          , Rr          , Rr          , Rr          
Xos         , Rr          , Rr          , Xos         , Rr          , Rr          , Rr          , Rr          , Rr          , Rr          , Rr          , Rr          , Rr          , Rr          , Rr^Bw/      , Rr          , Rr          , Rr          , Rr          , Xos         , Rr          , Rr          
Xos         , Rr          , Rr          , Rr          , Rr          , Rr          , Rr          , Rr          , Rr^Bw\      , Rr          , Rr          , Rr          , Rr^Bw/      , Rr^Bw/      , 8 Rr        , Rr          , Rr          , Rr          , Rr          , Rr          , Rr          , Rr          
Xos         , Rr          , Rr          , Xos         , Rr          , Rr          , Rr          , Xos         , 4 Rr        , Rr^Bw\      , Rr^Bw\      , Rr^Bw/      , 3 Rr        , Rr          , Rr          , Xos         , Rr          , Rr          , Rr          , Xos         , Rr          , Rr          
Xos         , Xos         , Xos         , Rr          , Rr          , Rr          , Rr          , Rr          , Rr          , Rr          , Rr          , Rr          , Rr          , Rr          , Rr          , Rr          , Rr          , Rr          , Rr          , Rr          , Rr          , Rr          
