border_size=1
usage=map

Wo          , Wo          , Wo          , Wo          , Wo          , Wo          , Wo          , Wo          , Wo          , Wo          , Wo          , Wo          , Wo          , Wo          , Wo          , Wo          , Wo          , Wo          , Wo          , Wo          , Wo          , Wo          , Wo          , Wo          , Wo          , Wo          
Wo          , Chw         , Chw         , Wo          , Wo          , Wo          , Wo          , Chw         , Ww          , Ww          , Ww          , Wwf         , Ww          , Wwf         , Ww          , Ww          , Ww          , Wo          , Wo          , Wo          , Wo          , Wo          , Wo          , Wo          , Wo          , Wo          
Ww          , Chw         , Chw         , Chw         , Chw         , Chw         , Ww          , Wo          , Ww          , Ww          , Ww          , Wwf         , Wwf         , Ww          , Ww          , Ww          , Ww          , Wo          , 1 Ww        , Wo          , Wo          , Wo          , Wo          , Wo          , Wo          , Wo          
Ww          , 2 Khw       , Chw         , Ww          , Ww          , Chw         , Ww          , Wwf         , Ww          , Ww          , Ww          , Ww          , Ww          , Ww          , Ww          , Ww          , Ww          , Ww          , Ww          , Wo          , Ww          , Ww          , Ww          , Ww          , Ww          , Ww          
Ww          , Chw         , Ww          , Chw         , Ww          , Chw         , Ww          , Ww          , Ww          , Ww          , Ww          , Wwf         , Ww          , Ww          , Ww          , Ww          , Ww          , Ww          , Ww          , Ww          , Ww          , Ww          , Ww          , Ww          , Ww          , Ww          
Re          , Ww          , Re          , Ww          , Ww          , Ww          , Ss          , Ww          , Wwf         , Ww          , Ww          , Ww          , Ww          , Ww          , Ww          , Ww          , Ww          , Ww          , Ww          , Ww          , Wo          , Ww          , Ww          , Ww          , Ww          , Ww          
Ww          , Ww          , Chw         , Ww          , Ww          , Ww          , Ww          , Ww          , Ww          , Ww          , Ww          , Ww          , Ww          , Ss^Vhs      , Re          , Ww          , Ss          , Ww          , Ww          , Ww          , Wo          , Wo          , Wo          , Wo          , Wo          , Wo          
Ww          , Ww          , Ww          , Ww          , Ww          , Ww          , Ww          , Wwf         , Wwf         , Ss          , Ss          , Wwf         , Wwf         , Ww          , Ww          , Ss          , Re          , Ww          , Ww          , Ww          , Ww          , Wo          , Wo          , Wo          , Wo          , Wo          
Ww          , Ww          , Ww          , Ww          , Ww          , Ww          , Ww          , Ww          , Ww          , Ww          , Ww          , Ss          , Ww          , Ww          , Ww          , Ww          , Ds          , Ss          , Ss^Vhs      , Ww          , Ss          , Ww          , Ww          , Wo          , Wo          , Wo          
Ww          , Ww          , Ww          , Ww          , Ww          , Ww          , Ww          , Ww          , Ww          , Ww          , Ww          , Ww          , Ww          , Ww          , Ds          , Ww          , Ww          , Ww          , Ww^Bw|      , Ss          , Ww          , Ww          , Ww          , Ww          , Ww          , Wo          
Ww          , Ww          , Ww          , Ww          , Ww          , Ss          , Ww          , Ww          , Ww          , Ww          , Ww^Vm       , Ww          , Ww          , Ww          , Ww          , Ds          , Ds          , Ds          , Ds          , Ds          , Ww          , Ww          , Ww          , Ww          , Ss          , Ww          
Ww          , Ww          , Ww          , Ww          , Ww          , Ww          , Ww          , Ww          , Ww          , Ww          , Ww          , Ss          , Ss          , Ss          , Ss          , Ww          , Ww          , Ww          , Ww^Bw|      , Ss          , Ss          , Ww          , Ww          , Ss          , Ss          , Ss          
Ss          , Ss          , Ss          , Ss          , Ss          , Ds          , Ss          , Ss          , Ss          , Gg          , Gg          , Gg          , Ss          , Gg          , Ss^Bw/      , Gg          , Ss          , Gg          , Gg          , Ds          , Ds          , Ds          , Gg          , Ss          , Ss          , Ss          
Ss          , Gg          , Gg          , Gg          , Gg          , Gg          , Ss          , Gg          , Ss          , Ss          , Ss          , Ds          , Ds          , Ds          , Ds          , Ss          , Gg          , Gg          , Ds          , Gg          , Ss          , Gg          , Ss          , Gg          , Gg          , Ww^Vm       
Ss          , Gg          , Gg          , Ds          , Ss          , Ss          , Ds          , Ss          , Ds          , Ss          , Ss^Bw/      , Ss^Bw/      , Ss          , Ds          , Ss          , Ss          , Ke          , Gg          , Ss          , Ss          , Gg^Bw/      , Ss^Vhs      , Ss^Bw\      , Ss          , Ss^Vhs      , Ss          
Ss          , Ss          , Ss          , Ss^Vhs      , Ss^Bw\      , Ss          , Gg          , Ss          , Ss          , Ss^Vhs      , Ss          , Gg          , Gg          , Ss          , Ce          , Ce          , Ce          , Ss          , Ss^Vhs      , Ss^Bw/      , Ds          , Ss          , Ss^Bw|      , Ss^Bw\      , Ss^Bw\      , Ss          
Ss          , Ds          , Ds          , Ss          , Ss          , Gg          , Gg          , Gg          , Gg^Bw/      , Ss^Bw|      , Gg          , Ss          , Ss          , Ss          , Ce          , 3 Ke        , Ce          , Ss^Bw/      , Ss          , Ds          , Ds          , Gg          , Ss^Bw|      , Ss          , Ds          , Ss^Bw\      
Ss          , Gg          , Ss          , Ss          , Gg          , Ss          , Ss^Vhs      , Gg^Bw/      , Ss          , Gg          , Ss          , Ds          , Ds          , Ss^Bw/      , Ss          , Ce          , Ss          , Ss          , Gg          , Ds          , Gg          , Ss          , Ss^Vhs      , Ss          , Ds          , Gg          
Gg          , Ss          , Gg          , Ss          , Gg          , Ss          , Gg          , Ss          , Gg          , Ss          , Gg          , Ss^Bw/      , Ss          , Ss          , Ss          , Ss          , Gg          , Ss          , Ss          , Ss          , Ss          , Ss          , Ss          , Ss          , Gg          , Ds          
