border_size=1
usage=map

Gg          , Gg          , Gg          , Gg          , Gg          , Gg          , Gg          , Gg          , Gg          , Gg          , Gg          , Gg          , Gg          , Gg          , Gg          , Gg          , Gg          , Gg          
Gg          , Gg          , Gg          , Gg          , Xos         , Gg          , Xos         , Gg          , Xos         , Gg          , Xos         , Gg          , Xos         , Gg          , Xos         , Gg          , Gg          , Gg          
Gg          , Gg          , Gg          , Xos         , Rr          , Xos         , Rr          , Xos         , Rr          , Xos         , Rr          , Xos         , Rr          , Xos         , Rr          , Xos         , Gg          , Gg          
Gg          , Gg          , Gg          , Xos         , 1 Rr        , Rr          , Rr          , Rr          , Rr          , Rr          , Rr          , Rr          , Rr          , Rr          , Rr          , Xos         , Gg          , Gg          
Gg          , Gg          , Gg          , Xos         , Rr          , Rr          , Rr          , Rr          , Rr          , Rr          , Rr          , Rr          , Rr          , Rr          , Rr          , Xos         , Gg          , Gg          
Gg          , Gg          , Gg          , Xos         , Rr          , Rr          , Rr          , Rr          , Rr          , Rr          , Rr          , Rr          , Rr          , Rr          , Rr          , Xos         , Gg          , Gg          
Gg          , Gg          , Gg          , Xos         , Xos         , Rr          , Rr          , Rr          , Rr          , Rr          , Rr          , Rr          , Rr          , Rr          , Rr          , Xos         , Gg          , Gg          
Gg          , Gg          , Gg          , Gg          , Gg          , Xos         , Xos         , Rr          , Xos         , Rr          , Ur          , Rr          , Xos         , Xos         , Xos         , Xos         , Gg          , Gg          
Gg          , Gg          , Gg          , Gg          , Gg          , Gg          , Gg          , Xos         , Gg          , Xos         , Xos         , Xos         , Gg          , Gg          , Gg          , Gg          , Gg          , Gg          
Gg          , Gg          , Gg          , Gg          , Gg          , Gg          , Gg          , Gg          , Gg          , Gg          , Gg          , Gg          , Gg          , Gg          , Gg          , Gg          , Gg          , Gg          
Gg          , Gg          , Xos         , Gg          , Xos         , Gg          , Xos         , Gg          , Xos         , Gg          , Xos         , Gg          , Xos         , Gg          , Xos         , Gg          , Gg          , Gg          
Gg          , Gg          , Xos         , Xos         , Rr          , Xos         , Rr          , Xos         , Rr          , Xos         , Rr          , Xos         , Rr          , Xos         , Uu          , Xos         , Gg          , Gg          
Gg          , Gg          , Xos         , Ur          , Ur          , Rr          , Ur          , Rr          , Rr          , Rr          , Rr          , Rr          , Rr          , Rr          , Rr          , Xos         , Gg          , Gg          
Gg          , Gg          , Xos         , Rr          , Ur          , Ur          , Rr          , Ur          , Ur          , Rr          , Rr          , Rr          , Ur          , Rr          , Uu          , Xos         , Gg          , Gg          
Gg          , Gg          , Xos         , Rr          , Rr          , Rr          , Rr          , Rr          , Rr          , Rr          , Rr          , Rr          , Rr          , Rr          , Rr          , Xos         , Gg          , Gg          
Gg          , Gg          , Xos         , Rr          , Rr          , Ur          , Rr          , Ur          , Rr          , Ur          , Rr          , Rr          , Rr          , Ur          , Rr          , Xos         , Gg          , Gg          
Gg          , Gg          , Gg          , Xos         , Rr          , Rr          , Rr          , Rr          , Rr          , Rr          , Rr          , Rr          , Ur          , Rr          , Uu          , Xos         , Gg          , Gg          
Gg          , Gg          , Gg          , Xos         , Xos         , Xos         , Xos         , Xos         , Xos         , Rr          , Xos         , Rr          , Xos         , Rr          , Xos         , Xos         , Gg          , Gg          
Gg          , Gg          , Gg          , Gg          , Gg          , Gg          , Gg          , Gg          , Gg          , Xos         , Gg          , Xos         , Gg          , Xos         , Gg          , Xos         , Gg          , Gg          
Gg          , Gg          , Gg          , Gg          , Gg          , Gg          , Gg          , Gg          , Gg          , Gg          , Gg          , Gg          , Gg          , Gg          , Gg          , Gg          , Gg          , Gg          
Gg          , Gg          , Gg          , Xos         , Xos         , Xos         , Xos         , Xos         , Xos         , Xos         , Xos         , Xos         , Xos         , Gg          , Gg          , Gg          , Gg          , Gg          
Gg          , Gg          , Gg          , Xos         , Rr          , Rr          , Rr          , Rr          , Rr          , Rr          , Rr          , Rr          , Xos         , Gg          , Gg          , Gg          , Gg          , Gg          
Gg          , Gg          , Gg          , Xos         , Rr          , Rr          , Rr          , Rr          , Rr          , Rr          , Rr          , Rr          , Xos         , Gg          , Gg          , Gg          , Gg          , Gg          
Gg          , Gg          , Gg          , Xos         , Rr          , Rr          , Rr          , Rr          , Rr          , Rr          , Rr          , Rr          , Xos         , Gg          , Gg          , Gg          , Gg          , Gg          
Gg          , Gg          , Gg          , Xos         , Rr          , Rr          , Rr          , Rr          , Rr          , Rr          , Rr          , Rr          , Uu          , Xos         , Gg          , Gg          , Gg          , Gg          
Gg          , Gg          , Gg          , Xos         , Xos         , Rr          , Rr          , Rr          , Rr          , Rr          , Xos         , Rr          , Xos         , Xos         , Gg          , Gg          , Gg          , Gg          
Gg          , Gg          , Gg          , Xos         , Gg          , Xos         , Xos         , Xos         , Xos         , Xos         , Gg          , Xos         , Gg          , Gg          , Gg          , Gg          , Gg          , Gg          
Gg          , Gg          , Gg          , Gg          , Gg          , Gg          , Gg          , Gg          , Gg          , Gg          , Gg          , Gg          , Gg          , Gg          , Gg          , Gg          , Gg          , Gg          
Gg          , Gg          , Gg          , Gg          , Gg          , Gg          , Gg          , Gg          , Gg          , Gg          , Gg          , Gg          , Gg          , Gg          , Gg          , Gg          , Gg          , Gg          
Gg          , Gg          , Gg          , Gg          , Gg          , Gg          , Xos         , Gg          , Xos         , Gg          , Xos         , Gg          , Gg          , Gg          , Gg          , Gg          , Gg          , Gg          
Gg          , Gg          , Gg          , Gg          , Xos         , Xos         , Rr          , Xos         , Rr          , Xos         , Rr          , Xos         , Xos         , Gg          , Gg          , Gg          , Gg          , Gg          
Gg          , Gg          , Gg          , Gg          , Xos         , Rr          , Rr          , Rr          , Rr          , Rr          , Rr          , Rr          , Xos         , Gg          , Gg          , Gg          , Gg          , Gg          
Gg          , Gg          , Gg          , Gg          , Xos         , Rr          , Rr          , Rr          , Rr          , Rr          , Rr          , Rr          , Xos         , Gg          , Gg          , Gg          , Gg          , Gg          
Gg          , Gg          , Gg          , Gg          , Gg          , Xos         , Xos         , Xos         , Xos         , Xos         , Xos         , Xos         , Gg          , Gg          , Gg          , Gg          , Gg          , Gg          
Gg          , Gg          , Gg          , Gg          , Gg          , Gg          , Gg          , Gg          , Gg          , Gg          , Gg          , Gg          , Gg          , Gg          , Gg          , Gg          , Gg          , Gg          
