border_size=1
usage=map

Gs          , Gs          , Gs          , Gs          , Gs^Dr       , Gs          , Chr         , Dd^Dc       , Chr         , Chr         , Chr         , Chr         , Chr         , Gs          , Gs^Fdw      , Gg          , Ds          , Gg          , Gs^Fds      , Gg          , Gs^Fds      , Gs^Fds      , Gs^Fds      , Gs^Fds      , Gs^Fms      , Gs^Fds      , Gs^Fms      , Gs^Fms      , Gs^Fp       , Gg          , Gs^Fds      , Gs^Fds      , Gs^Fds      , Gs^Fds      , Gs^Fds      , Gs^Fds      , Gs^Fds      , Gs^Fds      , Gs^Fds      
Gs          , Gg          , Ds          , Gs          , Ds          , Dd^Dc       , Ds          , Chr         , Chr         , Ds^Dr       , Chr         , Chr         , Gs^Fdw      , Gs^Fdw      , Ds          , Gs^Fds      , Re          , Gs^Fds      , Re          , Ds^Dr       , Re          , Gs^Fms      , Gs^Fdw      , Gs^Fms      , Gs^Fds      , Gs^Fms      , Gs^Fds      , Gs^Fms      , Gs^Fds      , Gs^Fds      , Gs^Fds      , Gs^Fds      , Hh^Fds      , Hh^Fds      , Hh^Fds      , Hh^Fds      , Hh^Fds      , Gs^Fds      , Gs^Fds      
Gs          , Gs          , Gs          , Ds          , Re          , Ds          , Dd^Dc       , Ds^Dr       , Chr         , 2 Khr       , Chr         , Chr         , Gs^Fdw      , Gs^Fdw      , Re          , Re          , Gs^Fdw      , Re          , Gs^Fms      , Gs^Fms      , Gs^Fp       , Re          , Gs^Fp       , Gs^Fds      , Gs^Fp       , Gs^Fp       , Gs^Fp       , Gs^Fp       , Gs^Fms      , Hh^Fds      , Hh^Fds      , Hh^Fds      , Hh          , Hh^Fp       , Hh^Fdw      , Hh^Fds      , Hh^Fdw      , Hh^Fds      , Gs^Fds      
Gs          , Re          , Gs^Dr       , Gs          , Ds          , Rd          , Rd          , Re          , Rd          , Ds          , Ds          , Chr^Dr      , Gs^Fdw      , Ds^Dr       , Re          , Gs^Fmw      , Ds^Dr       , Gs^Fms      , Re          , Ds          , Re          , Re          , Gs^Fms      , Gs^Fms      , Gs^Dr       , Hh^Fds      , Hh^Fds      , Gs^Fp       , Hh          , Hh^Fds      , Hh^Fdw      , Gs^Fp       , Hh          , Hh^Fmw      , Hh^Fmw      , Gs^Fmw      , Gs^Fmw      , Hh^Fds      , Gs          
Ds          , Gs          , Gs          , Ds          , Rd          , Rd          , Rp          , Rd          , Rd          , Rd          , Rd          , Dd^Dc       , Hh          , Gs^Fds      , Gs^Fdw      , Gs^Fdw      , Re          , Re          , Gs^Fmw      , Re          , Gs^Fms      , Ds^Dr       , Gs^Fms      , Gs^Fms      , Hh^Fdw      , Hh^Fds      , Hh          , Hh          , Gs^Fms      , Hh          , Hh^Fmw      , Hh^Fmw      , Gs^Fmw      , Hh^Fmw      , Gs^Fmw      , Gs^Fmw      , Gs          , Gs          , Gs          
Re          , Re          , Rp          , Re^Dr       , Ds          , Rd          , Rd          , Rd          , Rp          , Rd          , Re^Dr       , Rd          , Gs^Fdw      , Hh^Fdw      , Gs^Fdw      , Ds          , Gs^Fds      , Gs^Fds      , Gs^Fmw      , Gs^Fmw      , Gs^Fmw      , Gs^Fds      , Gs^Fds      , Hh^Fds      , Hh          , Hh^Fds      , Hh          , Hh^Fmw      , Hh^Fmw      , Gs^Fp       , Gs^Fmw      , Hh^Fmw      , Gs^Fmw      , Gs^Fmw      , Gs^Fmw      , Gs^Fmw      , Gs          , Gs^Dr       , Gs          
Ds          , Gs          , Chr         , Ds          , Ds          , Re          , Rd          , Rp          , Ds          , Rp          , Rp          , Hh          , Rp          , Gs^Fdw      , Ds          , Gs^Fds      , Ds^Dr       , Re          , Re          , Ds          , Gs^Fds      , Gs^Fmw      , Gs^Fds      , Hh^Fds      , Hh^Fmw      , Hh          , Gs          , Hh          , Gs^Fmw      , Gs^Fmw      , Gs^Fmw      , Gs^Fmw      , Gs^Fmw      , Gs^Fmw      , Gs^Fmw      , Gs          , Gs^Fmw      , Gs          , Gs          
Ds          , Ds          , Ch          , Re          , Ce          , Dd^Dc       , Ds          , Ds          , Gg          , Ds          , Ds          , Ds          , Ds          , Ds          , Ds          , Gs          , Gs          , Gs^Fds      , Re          , Gs^Fds      , Gs^Fds      , Gs^Fmw      , Ds          , Gs          , Ds          , Gs          , Ds          , Gs          , Gs^Fmw      , Gs^Fmw      , Gs^Fmw      , Gs^Fmw      , Gs^Fmw      , Gs^Fmw      , Gs^Fmw      , Gs^Fmw      , Gs^Fmw      , Gs^Fmw      , Re          
Rd          , Chr         , Chr         , Ch          , 4 Ke        , Ce          , Ce          , Ch^Dr       , Gg          , Ds          , Gs          , Gg          , Gs          , Ds          , Ds          , Ds          , Gs          , Gs          , Gs          , Gs          , Gs          , Ds          , Gs          , Ds          , Ds          , Ds          , Ds          , Gs          , Gs^Fmw      , Gs          , Gs^Fmw      , Gs^Fmw      , Gs^Fmw      , Gs^Fmw      , Gs^Fmw      , Gs^Fmw      , Gs^Fmw      , Gs          , Re          
Re          , Rd          , Rd          , Ch^Dr       , Khr         , Ce          , Re          , Chr         , Gg          , Ds          , Ds          , Ds          , Ds          , Ds          , Gs^Fmw      , Gs^Fmw      , Gs^Fmw      , Gs^Fmw      , Gs^Fmw      , Gs^Fmw      , Gs^Fmw      , Gs          , Ds          , Ds          , Gs^Fmw      , Ds          , Gs^Fmw      , Gs^Fmw      , Gs^Fmw      , Gs^Fmw      , Gs^Fmw      , Gs^Fmw      , Gs^Fmw      , Gs^Fmw      , Re          , Gs^Fmw      , Gs          , Gs          , Gs          
Re          , Re          , Re          , Rd          , Rd          , Chr         , Rd          , Re          , Re          , Gs^Dr       , Ds          , Ds          , Ds          , Gs          , Gs^Fmw      , Gg          , Ds          , Gg          , Gg          , Gs^Fmw      , Gs^Fmw      , Ds          , Ds          , Gs          , Ds          , Re          , Ds          , Gs^Fmw      , Gs          , Gs^Fmw      , Gs^Fmw      , Gs^Fmw      , Re          , Ds          , Ds          , Ds          , Gs          , Gs          , Gs          
Gg          , Re          , Re          , Re          , Ds          , Rd          , Ds          , Rd          , Re          , Re          , Ds          , Ds          , Ds          , Gs          , Gs^Fmw      , Ds          , Ds          , Gg          , Gs^Fmw      , Gs^Fmw      , Gs          , Ds          , Gs^Fmw      , Ds          , Re          , Ds          , Gs^Fmw      , Gs          , Gs          , Gs          , Gs^Fmw      , Re          , Ds          , Re          , Ds          , Gs          , Gs^Dr       , Gs          , Gs          
Gg          , Re          , Ds          , Re          , Ds          , Gg^Dr       , Ds          , Gs^Dr       , Rd          , Rd          , Rd          , Gs          , Gs          , Gs          , Gs          , Gs^Fmw      , Gs^Fmw      , Ds          , Gs          , Gs          , Gg          , Gs          , Gs          , Gs^Fmw      , Gs^Fmw      , Gs^Fmw      , Gs^Fmw      , Gs^Fmw      , Gs^Fmw      , Gs^Fmw      , Gs^Fmw      , Re          , Gs          , Gs          , Gs          , Ds          , Gs          , Gs          , Gs          
Gs          , Gs          , Ds^Dr       , Ds          , Gs          , Ds          , Gs          , Gs          , Gs^Fds      , Ds          , Gs^Fmw      , Rd          , Rd          , Rd          , Rd          , Rd          , Rd          , Gg          , Gs          , Ds          , Gg          , Ds          , Gg          , Gg          , Gg          , Gs^Fmw      , Gg          , Gs^Fmw      , Gs          , Re          , Ds          , Gs          , Re          , Ds          , Ds          , Gs          , Gs          , Gs          , Re          
Gs          , Gg          , Gs          , Gs          , Gs          , Ds          , Ds          , Gs^Fds      , Ds          , Ds          , Gs^Fmw      , Gs^Fds      , Gs^Fds      , Gs^Fds      , Gs^Fmw      , Rd          , Rd          , Gs          , Gg          , Gg          , Gs^Fmw      , Gs          , Gs^Fmw      , Gs          , Ds          , Ds          , Ds          , Gs^Fmw      , Re          , Gg          , Gs          , Gs          , Ds          , Ds          , Ds          , Gs          , Rd          , Rd          , Gs          
Gs          , Gs          , Gs^Fds      , Gs^Fds      , Gs^Fds      , Gs^Fds      , Ds          , Gs^Fds      , Gs^Fmw      , Ds          , Gs^Fds      , Gs^Fds      , Gs^Fds      , Gs^Fds      , Gs^Fds      , Gs^Fmw      , Gs          , Rd          , Rd          , Rd          , Rd          , Gs^Fmw      , Gs          , Gs^Fmw      , Gs^Fmw      , Gs^Fmw      , Gs^Fmw      , Gs^Fmw      , Gs^Fmw      , Gg          , Gs          , Gs^Dr       , Rd          , Rd          , Rd          , Rd          , Gs          , 1 Gs        , Gs          
Gs^Fds      , Gs^Fds      , Gs^Fds      , Gs^Fds      , Gs^Fds      , Gs^Fds      , Ds          , Gs^Fmw      , Ds          , Ds          , Gs^Fds      , Gs^Fp       , Gs^Fds      , Gs^Fds      , Gs^Fds      , Gs^Fds      , Gs^Fds      , Gs          , Gs          , Rd          , Gs^Fmw      , Gs          , Rd          , Gs^Fmw      , Rd          , Gs^Fmw      , Rd          , Gg          , Rd          , Rd          , Rd          , Rd          , Khr         , Ds          , Re          , Gs          , Gs^Dr       , Gs          , Gs          
Gs^Fds      , Gs^Fds      , Gs^Fds      , Hh^Fp       , Gs^Fds      , Gs^Fds      , Ds          , Ce          , Ds          , Gs^Fds      , Gs^Fds      , Gs^Fds      , Gs^Fds      , Gs^Fds      , Gs^Fds      , Gs^Fds      , Gs^Fds      , Gs^Fds      , Gs          , Gs          , Gs^Fds      , Gs^Fmw      , Gg          , Rd          , Gs          , Rd          , Gs          , Rd          , Gs          , Gs^Fmw      , Gs^Fmw      , Gs          , Gs          , Gs          , Ds          , Gs          , Gs          , Gs          , Ds          
Gs^Fds      , Gs^Fds      , Gs^Fds      , Hh^Fp       , Gs^Fds      , Gs^Fmw      , Ds          , Ce          , 3 Ke        , Ce          , Ce          , Gs^Fds      , Mm          , Gs^Fds      , Mm          , Gs^Fds      , Gs^Fds      , Gs^Fds      , Gs^Fds      , Gs^Fds      , Hh^Fp       , Gs^Fds      , Hh^Fp       , Mm          , Hh^Fp       , Hh^Fp       , Hh^Fp       , Gg          , Hh^Fp       , Gs          , Gs^Dr       , Gs          , Gs          , Gs          , Gs          , Gg          , Ds          , Gs          , Gs          
Gs^Fms      , Gs^Fms      , Gs^Fms      , Hh^Fp       , Gs^Fms      , Gs^Fp       , Gs^Fmw      , Ce          , Ce          , Ce          , Mm          , Mm          , Gs^Fms      , Mm          , Mm          , Mm          , Mm          , Mm          , Mm          , Mm          , Mm          , Mm          , Gs^Fp       , Hh^Fp       , Mm          , Hh^Fp       , Hh^Fp       , Hh^Fp       , Hh^Fms      , Gs          , Hh^Fds      , Gs          , Hh^Fds      , Gs          , Hh^Fds      , Gg          , Gg          , Gs          , Gs          
Gs^Fms      , Hh^Fp       , Gs^Fms      , Gs^Fms      , Hh^Fp       , Gs^Fms      , Hh          , Ce          , Hh^Fp       , Ce          , Gs^Fmw      , Gs^Fms      , Mm          , Gs^Fms      , Gs^Fms      , Mm          , Gs^Fms      , Gs^Fms      , Gs^Fp       , Gs^Fp       , Gs^Fp       , Gs^Fp       , Gs^Fp       , Hh          , Gs^Fds      , Mm          , Mm          , Hh^Fms      , Mm          , Hh^Fds      , Mm          , Hh^Fds      , Gg          , Hh^Fds      , Hh^Fds      , Hh^Fds      , Hh^Fds      , Gg          , Hh^Fds      
Gs^Fms      , Gs^Fms      , Hh^Fp       , Hh          , Hh^Fp       , Hh^Fms      , Hh          , Hh          , Hh          , Mm          , Hh          , Gs^Fms      , Hh^Fp       , Gs^Fms      , Gs^Fp       , Gs^Fp       , Hh          , Gs^Fms      , Gs^Fp       , Gs^Fp       , Gs^Fp       , Gs^Fp       , Mm          , Gs^Fp       , Gs^Fp       , Gs^Fp       , Gs^Fp       , Mm          , Gs^Fds      , Mm          , Gs^Fds      , Gg          , Mm          , Mm          , Mm          , Mm          , Mm          , Hh^Fds      , Gs          
Hh^Fp       , Gs^Fms      , Hh^Fp       , Hh          , Hh          , Hh^Fp       , Hh^Fp       , Hh          , Hh          , Hh^Fp       , Hh          , Hh^Fp       , Hh          , Gs^Fp       , Hh          , Gs^Fp       , Hh          , Gs^Fms      , Gs^Fp       , Gs^Fp       , Gs^Fp       , Gs^Fp       , Gs^Fp       , Gs^Fp       , Gs^Fp       , Gs^Fp       , Hh          , Hh          , Gs^Fds      , Gs^Fds      , Hh          , Gs^Fds      , Gs^Fds      , Gs^Fds      , Mm          , Gg          , Gs^Fds      , Mm          , Gs^Fds      
Gs^Fms      , Hh^Fp       , Gs^Fms      , Hh          , Hh          , Hh^Fms      , Hh          , Hh^Fms      , Hh^Fms      , Hh          , Hh^Fms      , Hh^Fms      , Hh          , Hh^Fp       , Hh          , Mm          , Gs^Fms      , Gs^Fms      , Gs^Fp       , Gs^Fp       , Gs^Fp       , Hh          , Gs^Fp       , Gs^Fp       , Gs^Fp       , Gs^Fp       , Gs^Fp       , Hh          , Mm          , Gs^Fds      , Gs^Fds      , Mm          , Gs^Fds      , Hh          , Gs^Fds      , Mm          , Gs^Fds      , Gs^Fds      , Gs^Fds      
Gs^Fds      , Gs^Fms      , Gs^Fms      , Gs^Fms      , Gs^Fms      , Gs^Fms      , Gs^Fms      , Gs^Fms      , Gs^Fms      , Mm          , Gs^Fms      , Gs^Fms      , Gs^Fms      , Gs^Fms      , Gs^Fms      , Gs^Fms      , Gs^Fms      , Gs^Fms      , Gs^Fms      , Gs^Fp       , Gs^Fp       , Gs^Fp       , Gs^Fp       , Gs^Fp       , Gs^Fp       , Gs^Fp       , Gs^Fp       , Gs^Fp       , Gs^Fds      , Gs^Fds      , Gs^Fds      , Gs^Fds      , Gs^Fds      , Gs^Fds      , Gs^Fds      , Gs^Fds      , Gs^Fds      , Gs^Fds      , Gs^Fds      
